11111111111111111111111111111111111111111111111111111111111
100000000011111111000000C10011111C1000000000000000000000001
100111111000000000000000C1000000001011111111111111111111101
1011111111111111111111111101111111100100000000001111000C101
10000000000000000000000000000000000010000111000000000000101
10111111111111111111111111111111111100000100101111111111101
10000000000000000000000000000000000000111100100000000000001
11111111111111111111111111111101111111001010101111111111111
10000000000000000000000000000001C100000000001000000000000C1
10111111111111111111111111111111010111111111101111111111111
10000000000000000000000000000000000100000000000000000000001
11111111111111111111111101111111110101111111111111111111101
10000000000000000000000001000000C101C1C00000000001000000101
10111111111111111111111111011101011111111111110000010000101
1000000000000000000000000100E10000000000001C001111111100101
11111111111111111111111101111100111111110010000000000000101
10000000000000000000000000010001000010000111111111111110101
1011111111111111111111111111C1100100001000P0000000000000101
10000000000000000000000000011111111111110111000000000000101
11111111111111111111111111010000010000010100011111111111101
100000000000000000000000000101100100100101011C0000000000001
10111111111111111011111111110010010111010010011111111111101
100000000000000000000000000001000001000C101000100010001C101
1111111111111111111111C111111111111111111000000010001000101
1CCCCC10000101000100010100100100100010010101111111111111101
1CCCCC10010000010000010000000000000000000100000000000000001
1CCCCC11111111111111111111111111111111110101111111111111101
1CCCCC00000000000000000000000000000000000101C00000000000001
11111111111111111111111111111111111111111111111111111111111
