1111111111111111111111111
1P00000000001100000000001
1011110111110111110111101
1C000100000000000100001E1
1011010111111111010111101
1000000000010000000000001
1111110111010111111101111
1000001010000100000010001
1111111111111111111111111
