111111111111111111111111111111111111111
1P0000C00110000000000000000C00000000001
101111110011011111111111000001111111111
100000000000000000000000001111111111111
111111111111111111110000000000000000011
100000C000000000000100000000CCC11100001
100111111111111110010001110000000000111
1001CCC000000000100100C0000000111111111
100101111111110010010000000CC1111111001
100100000000010010010001111000000000001
10011111011111001001000100001111011C011
100000000000000010000011E11111000011111
111111111111111111111111111111111111111
