11111111111111111111111111111111111111111111111111111111111
1ECCCCCCCCCCCCCCCCCCCCCCCCCCCCCCCCCCCCCCCCCCCCCCCCCCCCCCCC1
1CCCCCCCCCCCCCCCCCCCCCCCCCCCCCCCCCCCCCCCCCCCCCCCCCCCCCCCCC1
1CCCCCCCCCCCCCC1CCCCCCCCCCCCCCCCCCC111111111111111111111CC1
1CCCCCCCCCCCCC11CCCCCCCCCCCCCCCCCCCCCCCCCCCCCCCCCCCCCCC1CC1
1CCCCCCCCCCCC11CCCCCCCCCCCCCCCCCCCCCCCCCCCCCCCCCCCCCCCC1CC1
1CCCCCCCCCCC1CCCCCCCCCCCCCCCCCCCCCCCCCCCCCCCCCCCCCCCCCC1CC1
1CCCCCCCCCC1CCCCCCCCCCCCCCCCCCCCCC0C0C000CCCCCCCCCCCCCC1CC1
1CCCCCCCCC1CCCCCCCCCCCCCCCCCCCCCCC000CCC0CCCCCCCCCCCCCC1CC1
1CCCCCCCC1CCCCCCCCCCCCCCCCCCCCCCCCCC0CC0CCCCCCCCCCCCCCC1CC1
1CCCCCCC1CCCCCCCCCCCCCCCCCCCCCCCCCCC0C000CCCCCCCCCCCCC1CCC1
1CCCCCC1CCCCCCCCCCCCCCCCCCCCCCCCCCCCCCCCCCCCCCCCCCCCC1CCCC1
1CCCCC1CCCCCCCCCCCCCCCCCCCCCCCCCCCCCCCCCCCCCCCCCCCCC1CCCCC1
1CCCC111111111111111111111111111CCCCCCCCCCCCCCCCCCC1CCCCCC1
1CCCCCCCCCCCCCCCCCC1CCCCCCCCCCCCCCCCCCCCCCCCCCCCCC1CCCCCCC1
1CCCCCCCCCCCCCCCCCC1CCCCCCCCCCCCCCCCCCCCCCCCCCCCC1CCCCCCCC1
1CCCCCCCCCCCCCCCCCC1CCCCCCCCCCCCCCCCCCCCCCCCCCCC1CCCCCCCCC1
1CCCCCCCCCCCCCCCCCC1CCCCCCCCCCCCCCCCCCCCCCCCCCC1CCCCCCCCCC1
1CCCCCCCCCCCCCCCCCC1CCCCCCCCCCCCCCCCCCCCCCCCCC1CCCCCCCCCCC1
1CCCCCCCCCCCCCCCCCC1CCCCCCCCCCCCCCCCCCCCCCCCC1CCCCCCCCCCCC1
1CCCCCCCCCCCCCCCCCC1CCCCCCCCCCCCCCCCCCCCCCCC1CCCCCCCCCCCCC1
1CCCCCCCCCCCCCCCCCC1CCCCCCCCCCCCCCCCCCCCCCC1CCCCCCCCCCCCCC1
1CCCCCCCCCCCCCCCCCC1CCCCCCCCCCCCCCCCCCCCCC1CCCCCCCCCCCCCCC1
1CCCCCCCCCCCCCCCCCC1CCCCCCCCCCCCCCCCCCCCC111111111111111CC1
1CCCCCCCCCCCCCCCCCCCCCCCCCCCCCCCCCCCCCCCCCCCCCCCCCCCCCCCCC1
1CCCCCCCCCCCCCCCCCCCCCCCCCCCCCCCCCCCCCCCCCCCCCCCCCCCCCCCCC1
1CCCCCCCCCCCCCCCCCCCCCCCCCCCCCCCCCCCCCCCCCCCCCCCCCCCCCCCCC1
1CCCCCCCCCCCCCCCCCCCCCCCCCCCCCCCCCCCCCCCCCCCCCCCCCCCCCCCCP1
11111111111111111111111111111111111111111111111111111111111
