111111111111
1P0011000101
11100C011101
1000010000C1
1E00010000r1
111111111111